{   
    "size": 16,

    "wall_height": 48,
    "wall_width": 48,
    
    "wall_map": [
        [5, 5, 4, 4, 4, 5, 5, 5, 5, 5, 5, 5, 5, 5, 5, 5],
        [5, 0, 0, 0, 0, 0, 5, 0, 0, 0, 0, 0, 0, 0, 0, 5],
        [5, 3, 0, 0, 0, 0, 5, 0, 0, 0, 0, 3, 0, 0, 0, 4],
        [5, 0, 0, 0, 0, 0, 5, 0, 0, 0, 0, 0, 0, 0, 1, 4],
        [5, 0, 0, 0, 0, 5, 5, 0, 4, 0, 0, 0, 0, 0, 0, 4],
        [5, 0, 0, 0, 0, 4, 0, 0, 4, 0, 0, 0, 0, 0, 0, 5],
        [5, 0, 1, 0, 0, 4, 0, 0, 5, 0, 0, 3, 0, 0, 0, 5],
        [5, 3, 0, 0, 0, 5, 0, 0, 5, 5, 5, 4, 5, 0, 0, 5],
        [5, 0, 0, 0, 0, 5, 0, 0, 0, 0, 0, 0, 5, 0, 0, 5],
        [4, 0, 0, 0, 0, 5, 5, 0, 4, 0, 0, 0, 5, 0, 0, 5],
        [4, 0, 0, 0, 0, 0, 0, 0, 5, 0, 1, 3, 5, 5, 0, 5],
        [4, 0, 0, 3, 0, 5, 0, 5, 5, 0, 0, 0, 0, 0, 0, 5],
        [4, 0, 0, 0, 0, 5, 0, 0, 5, 0, 0, 0, 0, 5, 5, 5],
        [5, 0, 1, 0, 0, 5, 0, 5, 5, 0, 0, 0, 0, 5, 3, 5],
        [5, 0, 0, 3, 0, 5, 0, 0, 0, 3, 0, 0, 0, 0, 0, 5],
        [5, 4, 4, 5, 5, 5, 5, 5, 5, 5, 5, 5, 5, 5, 5, 5]
    ],
    "floor_map": [
        [1, 2, 1, 2, 1, 2, 1, 2, 1, 2, 1, 2, 1, 2, 1, 2],
        [1, 2, 1, 2, 1, 2, 1, 2, 1, 2, 1, 2, 1, 2, 1, 2],
        [1, 2, 1, 2, 1, 2, 1, 2, 1, 2, 1, 2, 1, 2, 1, 2],
        [1, 2, 1, 2, 1, 2, 1, 2, 1, 2, 1, 2, 1, 2, 1, 2],
        [1, 2, 1, 2, 1, 2, 1, 2, 1, 2, 1, 2, 1, 2, 1, 2],
        [1, 2, 1, 2, 1, 2, 1, 2, 1, 2, 1, 2, 1, 2, 1, 2],
        [1, 2, 1, 2, 1, 2, 1, 2, 1, 2, 1, 2, 1, 2, 1, 2],
        [1, 2, 1, 2, 1, 2, 1, 2, 1, 2, 1, 2, 1, 2, 1, 2],
        [1, 2, 1, 2, 1, 2, 1, 2, 1, 2, 1, 2, 1, 2, 1, 2],
        [1, 2, 1, 2, 1, 2, 1, 2, 1, 2, 1, 2, 1, 2, 1, 2],
        [1, 2, 1, 2, 1, 2, 1, 2, 1, 2, 1, 2, 1, 2, 1, 2],
        [1, 2, 1, 2, 1, 2, 1, 2, 1, 2, 1, 2, 1, 2, 1, 2],
        [1, 2, 1, 2, 1, 2, 1, 2, 1, 2, 1, 2, 1, 2, 1, 2],
        [1, 2, 1, 2, 1, 2, 1, 2, 1, 2, 1, 2, 1, 2, 1, 2],
        [1, 2, 1, 2, 1, 2, 1, 2, 1, 2, 1, 2, 1, 2, 1, 2],
        [1, 2, 1, 2, 1, 2, 1, 2, 1, 2, 1, 2, 1, 2, 1, 2]
    ],
    "ceiling_map": [
        [2, 3, 3, 3, 2, 1, 2, 1, 2, 1, 2, 1, 2, 1, 2, 1],
        [2, 3, 3, 3, 2, 1, 2, 1, 2, 1, 2, 1, 2, 1, 2, 1],
        [2, 3, 3, 3, 2, 1, 2, 1, 2, 3, 3, 3, 3, 1, 2, 1],
        [2, 3, 3, 3, 2, 1, 2, 1, 2, 3, 3, 3, 3, 1, 2, 1],
        [2, 3, 3, 3, 3, 3, 3, 1, 2, 1, 2, 3, 3, 1, 2, 1],
        [2, 3, 3, 3, 3, 3, 3, 1, 2, 1, 2, 1, 2, 1, 2, 1],
        [2, 3, 3, 3, 3, 3, 3, 1, 2, 1, 2, 1, 2, 1, 2, 1],
        [2, 1, 2, 1, 2, 1, 2, 1, 2, 1, 2, 1, 2, 1, 2, 1],
        [2, 1, 2, 1, 2, 1, 2, 1, 2, 1, 2, 1, 2, 1, 2, 1],
        [2, 1, 2, 1, 2, 1, 2, 1, 3, 3, 3, 3, 3, 3, 2, 1],
        [2, 1, 2, 1, 2, 1, 2, 1, 3, 3, 3, 3, 3, 3, 2, 1],
        [2, 1, 2, 3, 3, 1, 2, 1, 3, 3, 3, 3, 3, 3, 2, 1],
        [2, 1, 2, 3, 3, 1, 2, 1, 3, 3, 3, 3, 3, 3, 2, 1],
        [2, 3, 3, 3, 3, 1, 2, 1, 3, 3, 3, 3, 3, 3, 2, 1],
        [2, 3, 3, 3, 3, 1, 2, 1, 2, 1, 2, 1, 2, 1, 2, 1],
        [2, 3, 3, 3, 3, 1, 2, 1, 2, 1, 2, 1, 2, 1, 2, 1]
    ],

    "wall_props": {
        "4": {
            "texture": "images/blocks.atl#window",
            "opaque": true
        },
        "5": { 
            "texture": "images/blocks.atl#cool_texture"
        } 
    },

    "platform_props": {
        "1": "images/blocks.atl#floor1",
        "2": "images/blocks.atl#floor2",
        "3": "images/blocks.atl#window"
    },

    "map_camera": {
        "x": 0,
        "y": 20,
        "height": 40,
        "angle": 90
    },
    "map_skybox": {
        "left": "images/skybox.atl#normal",
        "front": "images/skybox.atl#moon",
        "right": "images/skybox.atl#normal",
        "back": "images/skybox.atl#normal"
    }
}